3
7XXXXXXXXXXXXXXXXXXX
7XXXXXXXXXXGXXXXXXXX
7XXXXXX23XXXXXXXXXXX
7XXXXX243XXXXXXXXXXX
723XXXXXXXXXXXXXXXXX
7X23XXXXXXXXXXXXXXXX
7XX23XXXXXXXXXXXXXXX
7XXXXX23XXXXXXXXXXXX
7XX2443XXXXXXXXXXXXX
7XXXXXXXX243XXXXXXXX
7XXXXXXX26663XXXXXXX
244444444444443XX243

XXXXXXXXXXXXXXXXXXXX
XXXXXXXXXXXXXXXXXXXX
XXXXXXXXXXXXXXXXXXXX
XXXXXXXXXXXXXXXXXXXX
XXXXXXXXXXXXXXXXXXXX
XXXXXXXXXXXGXXXXXXXX
XXXXXXXXXXXXXXXXXXXX
XXXXXXXXX24XX4XX2XX3
XXXXXXX23XXXXXXXXXXX
XXXXXX243XXXXXXXXXXX
XXXXX243XXXXXXXXXXXX
2444444443XXXXXXXXXX

XXXXXXXXXXXXXXXXXXG5
XXXXXXXXXXXXXXXX3XX5
XXXXXXXXXXXXXX3XXXX5
XXXXXXXXXXX23XXXXX55
XXXXXXXX23XXXXXXXXX5
XXXXX23XXXXXXXXXXXX5
XX23XXXXXXXXXXXXXXX5
244444444443XXXXXXX5
566666666667XXXXXXX5
566666666667XXXXXXX5
566666666667XXXXXXX5
566666666667XXXXXXX5
